Unit 1:
  - traction: sự kéo 
  - manifestation: biểu hiện
  - recognition: sự công nhận
  - persuasive: thuyết phục
  - perceptions: nhận thức
  - convey: chuyển tải, chuyên chở (convey information,...)
  - exposure: 
  - exclusive: loại trừ
  - consultant: chuyên gia tư vấn
Unit 4:
  - approval (n): phê duyệt, chấp thuận
  - authority (n): thẩm quyền
  - archive (v/n): lưu trữ / kho lưu trữ
  - avenue (n): đại lộ (đường lớn)
  - bureaucratic (adj): quan liêu
  - comparable (adj): có thể so sánh
  - compensation (n): sự đền bù
  - conservative (adj): bảo thủ
  - controversial (adj): gây tranh cãi
  - democratic (adj): dân chủ
  - emphasis (n): sự nhấn mạnh
  - superficial (adj): hời hợt, không sâu sắc
  - hierarchical (adj): thứ bậc
  - incentive (n): khuyến khích
  - enquiry (n): cuộc điều tra
  - pattern (n): khuôn mẫu
  - probe (v/n): thăm dò / sự điều tra
  - progressive (adj): phát triển, xảy ra dần dần
  well established: được nhiều người biết đến
Unit 6:
  - aggressively (adv): một cách giận dữ và bạo lực / một cách quyết tâm mạnh 
  - bankrupt (adj) / bankruptcy (n): phá sản
  - commodity (n): hàng
  - depression (n): trì trệ
  - disastrous (adj): tai hại (extremely bad or unsuccessful)
  - dividend (n): cổ tức
  - downturn (n): suy thoái
  - emerging (adj): mới nổi (starting to exist)
  - equity (n): vốn chủ sở hữu / equity stake: cổ phần
  - expertise (n): chuyên môn
  - esoteric (adj): bí truyền, độc 
  - inflation (n): lạm phát
  - intention (n): có ý định, có chủ đích
  - interim (adj): tạm thời
  - recession (n): thời kỳ suy
  - perceive (v): nhận thức
  - potential (n/adj): tiềm năng / có khả năng xảy khi đủ điều kiện cần
  - versatile (adj): linh 
  credit crunch (n): khủng hoảng tín dụng
  interest rate: lãi suất
Unit 9:
  - appropriate (adj): phù hợp
  - barrier (n): rào cản
  - circumstance (n): trường hợp, hoàn cảnh
  - conscious (adj): nhận thức, biết rõ
  - despatch (dispatch) (v): gửi đi
  - guarantee (n): đảm bảo
  - insurance (n): bảo hiểm
  - negotiable (adj): có thể thương
  - self-discipline (n): kỷ luật tự giác
  - strategic (adj): chiến lược
  strategic industry: ngành chiến lược, ngành mũi nhọn
  - subsidy (n): trợ cấp
  - liberalize (v): tự do hóa
  - misnomer (n): nhầm lẫn
  - prestigious (adj): tín nhiệm, uy tín
  - principle (n): nguyên tắc, nguyên lý
  - quota (n): hạn ngạch
  - restriction (n): hạn chế
  - regulation (n): quy định / deregulation (n): bãi bỏ quy định
  - tariffs (n): thuế quan
  - tweak (v): thay đổi nhỏ nhằm tốt hơn
  - versatile (adj): linh hoạt
  - vital (adj): thiết yếu
  at the other end of the spectrum: nhìn đến cuối cùng (spectrum: quang phổ)
  infant industry: ngành công nghiệp sơ sinh
  peak time: thời gian cao điểm
Unit 10: Ethics
  - conservation (n): bảo tồn
  - corporate (adj): liên quan đến công ty lớn
  - degrade (v): không xem trọng, không tôn trọng
  - desperate (adj): tuyệt vọng
  - fictitious (adj): hư cấu
  - inspire (v): truyền cảm hứng
  - innovate (v): đổi mới
  - motivate (v): động viên
  - prestigious (adj): uy tín
  - reputation (n): danh tiếng
  * fundamentally: về cơ bản